- AGD : Administrateur général des données

- AIFE : Agence pour l'informatique financière de l'État

- AMD : Administrateur ministériel des données

- ANFR : Agence Nationale des Fréquences

- ANSM : Agence Nationale de Sécurité et du Médicament

- ANSSI : Agence nationale de sécurité des systèmes d’information

- ARCEP : Autorité de régulation des communications électroniques et
  des postes

- ARS : Agences régionales de santé.

- AVURNAV : Avis urgents aux navigateurs

- CADA : Commission d'accès aux documents administratifs

- DAM : Direction des affaires maritimes

- DGCS : Direction Générale de la Cohésion Sociale

- DHUP : Direction de l'habitat, de l'urbanisme et des paysages

- DINSIC : Direction interministérielle des systèmes d'information et
  de communication de l'État

- DIRECCTE : Direction régionale des entreprises, de la concurrence,
  de la consommation, du travail et de l'emploi

- DNE : Direction du numérique pour l’éducation

- DREES : Direction de la recherche, des études, de l’évaluation et
  des statistiques

- EPA : Établissement public administratif.  Voir EPIC

- EPIC : Établissement public industriel et commercial.  Voir EPA

- FINESS : Fichier National des Etablissements Sanitaires et Sociaux

- GHT : Groupes hospitaliers territoriaux.

- HAS : Haute autorité de santé

- HATVP : Haute autorité pour la transparence de la vie publique

- OIV : Organisme d’importance vitale

- PMSI : Programme de médicalisation des systèmes d’information (PMSI
  MCO : en médecine, chirurgie, obstétrique et odontologie)

- RIE : Réseau interministériel de l’État

- RIM : Réunion interministérielle

- RNA : Répertoire national des associations

- SCN : Service à compétence nationale

- SDIS : Service d’incendie et de Secours

- SGDSN : Secrétariat général de la défense et de la sécurité
  nationale

- SHOM : Service hydrographique et océanographique maritime

- SNDS : Système national des données de santé

- SPM : Service du premier ministre

- SSM : Service statistique ministériel
